{
  "map_id": "final_boss",
  "dimensions": { "width": 50, "height": 50 },
  "legend": {
    "#": "WALL_STONE",
    ".": "FLOOR_CLEAN",
    "P": "PLAYER_START",
    "N": "The Final Author"
  },
  "grid": [
    "##################################################",
    "#................................................#",
    "#................................................#",
    "#................................................#",
    "#................................................#",
    "#................................................#",
    "#................................................#",
    "#................................................#",
    "#................................................#",
    "#................................................#",
    "#................................................#",
    "#................................................#",
    "#................................................#",
    "#................................................#",
    "#................................................#",
    "#................................................#",
    "#................................................#",
    "#................................................#",
    "#................................................#",
    "#................................................#",
    "#................................................#",
    "#................................................#",
    "#................................................#",
    "#................................................#",
    "#........................P.......................#",
    "#................................................#",
    "#................................................#",
    "#................................................#",
    "#................................................#",
    "#................................................#",
    "#................................................#",
    "#................................................#",
    "#................................................#",
    "#................................................#",
    "#................................................#",
    "#................................................#",
    "#................................................#",
    "#................................................#",
    "#................................................#",
    "#................................................#",
    "#................................................#",
    "#................................................#",
    "#................................................#",
    "#................................................#",
    "#................................................#",
    "#................................................#",
    "#................................................#",
    "#................................................#",
    "#................................................#",
    "##################################################"
  ],
  "entities": {},
  "module_sockets": []
}
