{
  "map_id": "forest",
  "dimensions": {
    "width": 120,
    "height": 120
  },
  "legend": {
    "#": "Wall Tile",
    ".": "Floor Tile",
    "B": "Barrel",
    "S": "Bench",
    "l": "Candelabra",
    "v": "Ink Puddle",
    "d": "Ink Urn",
    "h": "Bookcase",
    "T": "Structure",
    "K": "Rock",
    "W": "Warp",
    "P": "Player Start",
    "C": "Chronicler",
    "F": "Wellspring",
    "L": "Lore",
    "R": "Respite",
    "A": "Bat",
    "Z": "Slug",
    "f": "Flutter",
    "b": "Bindling",
    "s": "Smear",
    "E": "Miniboss M1",
    "2": "Miniboss M2",
    "3": "Miniboss M3"
  },
  "grid": [
    "........................................................................................................................",
    "........................................................................................................................",
    "........................................................................................................................",
    "........................................................................................................................",
    "........................................................................................................................",
    "........................................................................................................................",
    "........................................................................................................................",
    "............................................................#...........................................................",
    ".............................................................##...............##........................................",
    "..............................................................##..............#.........................................",
    "............#.............................#....................##............#..........................................",
    ".............#............................##....................##.........##...........................................",
    "..............#.###..##.#..................##....................##.......#.............................................",
    "..............#...........###...............##....................#......#.................................##...........",
    "..............#.............#..........................................##...............................................",
    "...............##...........#.........................................#.................................#...............",
    "................##..........#.................#......................##....................Z............................",
    ".................##.........#..................#.....................#................................#.................",
    "..................##........#..................#...................##...................................................",
    "...................#..............................................##..............................#.....................",
    "....................#......#....................##...............#......................................................",
    "...........................#.....................#..............#.......................................................",
    "...........................#.....................##...........##..............................#.........................",
    "...........................##.....................#...........#.............................#...........................",
    "............................#.....................##....................................................................",
    "...................................................#.....................................#..............................",
    "............................#...........................................................................................",
    "............................#.......................#...................................#...............................",
    "...........................#..........................................................#.................................",
    "......................................................#..............................#..................................",
    "...........................#........Z.................#.............................##..................................",
    "..........................##...........................#............................#...................................",
    "..........................#.........................................................#...................................",
    "..........................#.........................................................#...................................",
    ".........................##.........................................................#..................Z................",
    "........................##.........................................................##...................................",
    "........................#.........................................................##....................................",
    "........................##......................A................................##.....................................",
    ".........................##......................................................#......................................",
    "..........................#......................................................#......................................",
    "..........................#.......................................................#.....................................",
    "..........................#........................................................#....................................",
    "..........................#.............................................................................................",
    "..........................#..........................................................#..................................",
    ".........................#............................................................##................................",
    ".........................#..............................................................................................",
    ".........................#.............................................................##...............................",
    "........................#...............................................................................................",
    "........................#...............................................................#...............................",
    "........................#................................................................#..............................",
    "........................#................................................................#..............................",
    ".......................#..................................................................#.............................",
    ".......................#.................................................Z................##............................",
    ".......................#....................................................................#...........................",
    ".......................#...........Z.........................................................##.........................",
    ".......................#........................................................................#.......................",
    ".......................#........................................................................##......................",
    ".......................#.........................................................................#......................",
    ".......................#..........................................#...............................#.....................",
    ".......................##.........................................#...............................#............Z........",
    "........................#...................................RE....#######..........................#....................",
    ".........................#...............................................#..........................#...................",
    "..................#......#................................................#.........................#...................",
    "..................#.......#................................................#.........Z..............#...................",
    "..................#........#................................................#.......................#...................",
    "..................#.........#...............................................##......................#...................",
    "..................#..........#...............................................##.....................#...................",
    ".................##...........#.........................A.....................#.....................#...................",
    "................##............#.....................................................................#...................",
    "...............##..............#..............................................#.....................#...................",
    "..............#................#..............................................#.....................#...................",
    ".............##................#..............................................#.....................#...................",
    ".............#..................#..................Z................................................##..................",
    "............##...................#............................................#......................#..................",
    "............#....................##.....................................................................................",
    "............#.....................#...................................................................#.................",
    "...........#.......Z...............#...................................................................#................",
    "...........#......................##.........................................#.........................##...............",
    "..........#......................#......................................................................##......A.......",
    ".........................................................................................................#..............",
    "................................#.........................................................................#.............",
    "...............................##.........................................................................#.............",
    "...............................#...........................................................................##...........",
    ".............................................................................#..............................#...........",
    "............................................................................#...........................................",
    "............................................................................#.....................Z.....................",
    "...........................................................................#............................................",
    "........................................................................................................................",
    "........................................................................................................................",
    "................................A.......................................................................................",
    "........................................................................................................................",
    "........................................................................................................................",
    "........................................................................................................................",
    "........................................................................................................................",
    "........................................................................................................................",
    "....................................Z...................................................................................",
    "........................................................................................................................",
    "........................................................................................................................",
    "........................................................................................................................",
    ".............................................................Z..........................................Z...............",
    "........................................................................................................................",
    "...............Z........................................................................................................",
    "........................................................................................................................",
    "........................................................................................................................",
    "........................................................................................................................",
    "........................................................................................................................",
    "........................................................................................................................",
    "........................................................................................................................",
    "........................................................................................................................",
    "........................................................................................................................",
    "........................................................................................................................",
    "........................................................................................................................",
    "...............................................................................................................A........",
    "........................................................................................................................",
    "........................................................................................................................",
    "........................................................................................................................",
    "........................................................................................................................",
    "........................................................................................................................",
    "........................................................................................................................",
    "........................................................................................................................"
  ],
  "entities": {},
  "module_sockets": []
}