{
  "map_id": "night_boss_arena",
  "dimensions": {
    "width": 40,
    "height": 40
  },
  "legend": {
    "#": "Wall Tile",
    ".": "Floor Tile",
    "B": "Barrel",
    "S": "Bench",
    "l": "Candelabra",
    "v": "Ink Puddle",
    "d": "Ink Urn",
    "h": "Bookcase",
    "T": "Structure",
    "K": "Rock",
    "W": "Warp",
    "P": "Player Start",
    "C": "Chronicler",
    "F": "Wellspring",
    "L": "Lore",
    "R": "Respite",
    "A": "Bat",
    "Z": "Slug",
    "f": "Flutter",
    "b": "Bindling",
    "s": "Smear",
    "E": "Miniboss M1",
    "2": "Miniboss M2",
    "3": "Miniboss M3"
  },
  "grid": [
    "........................................",
    "........................................",
    "........................................",
    ".....####.......................####....",
    ".....####.......................####....",
    ".....####.......................####....",
    ".....####.......................####....",
    "........................................",
    "........................................",
    "........................................",
    "........................................",
    "........................................",
    "........................................",
    "........................................",
    "........................................",
    "........................................",
    "........................................",
    "........................................",
    "........................................",
    "........................................",
    "......BB.........................BB.....",
    "......BB.........................BB.....",
    "........................................",
    "........................................",
    "........................................",
    "........................................",
    "........................................",
    "........................................",
    "........................................",
    "........................................",
    "................................####....",
    ".....####.......................####....",
    ".....####.......................####....",
    ".....####.......................####....",
    ".....####...............................",
    "........................................",
    "........................................",
    "........................................",
    "........................................",
    "........................................"
  ],
  "entities": {},
  "module_sockets": []
}