{
  "map_id": "ruins",
  "dimensions": {
    "width": 120,
    "height": 120
  },
  "legend": {
    "#": "Wall Tile",
    ".": "Floor Tile",
    "B": "Barrel",
    "S": "Bench",
    "l": "Candelabra",
    "v": "Ink Puddle",
    "d": "Ink Urn",
    "h": "Bookcase",
    "T": "Structure",
    "K": "Rock",
    "W": "Warp",
    "P": "Player Start",
    "C": "Chronicler",
    "F": "Wellspring",
    "L": "Lore",
    "R": "Respite",
    "A": "Bat",
    "Z": "Slug",
    "f": "Flutter",
    "b": "Bindling",
    "s": "Smear",
    "E": "Miniboss M1",
    "2": "Miniboss M2",
    "3": "Miniboss M3"
  },
  "grid": [
    "........................................................................................................................",
    "........................................................................................................................",
    "........................................................................................................................",
    "........................................................................................................................",
    "........................................................................................................................",
    "........................................A...............................Z...............................................",
    "........................................................................................................................",
    "........................................................................................................................",
    "........................................................................................................................",
    "............................................................................................#####################.......",
    "............................................................................................#...................#.......",
    "................................................................#############################...................#.......",
    ".....................................................................................A......#...................#.......",
    "............................................................................................#...................#.......",
    "............................................................................................#..................A#.......",
    "............................................................................................#...................#.......",
    ".........................A.......................###################.......................A#...................#.......",
    "............................................................................................#...................#.......",
    "............................................................................................#..........b...Z....#.......",
    "..............................................................................b.............#...................#.......",
    "..............................................#.............................................#...................#.......",
    "..............................................#.............................................#...................#.......",
    "..............................................#................................................................A#.......",
    "..............................................#.................................................................#.......",
    "..............................................#.................................................................#.......",
    "..............................................#............Z................................#...................#.......",
    "..............................................#..........b..................................#...................#.......",
    "..............................................#.............................................######.....##########.......",
    "..............................................#######.........##########.......................#............#...........",
    "....................................................#.........#................................#............#...........",
    "..................Z.................................#.........#................................#............#...........",
    "....................................................#A.......A#................................#............#...........",
    "....................................................#.........#....#...........................#............#...........",
    "....................................................#.........#....#...........................#............#...........",
    "....................................................#.........#....#....A......................#......Z.....#...........",
    "....................................................#.........#....###.........................#............#...........",
    "....................................................#.........#......#.........................#............#...........",
    "....................................................#A.......A#......#.........................#...Z........#...........",
    "....................................................#.........#......#.........................#............#...........",
    "................................................#####.........#......#.........................#............#...........",
    "................................................#.............#####..#.........................#............#...........",
    "................................................#.................#..#....A....................#............#...........",
    "................................................#.................#..#......................................#...........",
    "................................................#Z................#..#......................................#...Z.......",
    "................................................#.................#..#......................................#...........",
    "................................................#.................#..#......................................#...........",
    "................................................#.................#A.##########.......................Z.....#...........",
    "................................................#.................#...........#...........Z.................#...........",
    "....................A...........................#.................#..........A#................#............#...........",
    "................................................#.................#...........#................#............#...........",
    "................................................#.................#...........#................#............#...........",
    "................................................#.................#...........#................#............#...........",
    "................................................#.................#######.....#................#............#...........",
    "................................................#########.........####..#.....#.........##########.......####...........",
    "................................................#....................#..#.....#.........................................",
    "................................................#....................#..#.....#.........................................",
    "................................................#....................#..#.....#.........................................",
    "................................................#....................#..#.....#.........................................",
    "................................................#....................#..#.....#.........................................",
    "................................................#....................#..#.....#.........................................",
    "...................................#............#..........ER........#..#.....#.........................................",
    "...................................#............#....................#..#.....#...Z..........................#..........",
    "...................................#............#....................#..#.....#..............................#..........",
    "..................................##............#....................#..#.....#.....................b.......##..........",
    "..................................#.............#....................#..#.....#.............................#...........",
    "..................................#.............#....................#..#.....#.............................#...........",
    "...........Z......................##............#....................####.....#.............................#...........",
    "...................................#............#.............................#............................##...........",
    "...................................#............#.............................#...........................##............",
    "...................................#............#.............................#..........................##.............",
    "...................................##...........#......Z.............##########.........................##..............",
    "....................................#...........######################.................................##...............",
    "....................................#..................................................................#................",
    "....................................#..................................................................#................",
    "....................................#..................................................................#................",
    "..........................A.........#...................................................................................",
    "....................................#...................................................................................",
    "....................................#...................................................................................",
    "....................................#..Z................................................................................",
    "....................................#...................................................................................",
    "....................................#...................................................................................",
    "....................................##..................................................................................",
    ".....................................#..................................................................................",
    ".....................................#..................................................................................",
    ".....................................#..................................................................................",
    ".....................................#..................................................................................",
    ".....................................####...............................................................................",
    "........................................####............................................................................",
    "..........................................######................................Z....................#..................",
    "...............Z...............................###...................................................#..................",
    ".....................................................................................................#..................",
    "..............................................................................Z..Z...................#..................",
    ".....................................................................................................##.................",
    "......................................................................................................#.................",
    ".....................................................................................................##.................",
    ".....................................................................................................#..................",
    "....................................................................................................##..................",
    "................................................................................................#####...................",
    "...........................................................................................######.......................",
    "........................................................................................###.............................",
    "........................................................................................................................",
    "........................................................................................................................",
    "........................................................................................................................",
    "........................................................................................................................",
    "........................................................................................................................",
    "........................................................................................................................",
    "........................................................................................................................",
    "........................................................................................................................",
    "........................................................................................................................",
    "........................................................................................................................",
    "........................................................................................................................",
    "........................................................................................................................",
    "........................................................................................................................",
    "........................................................................................................................",
    "........................................................................................................................",
    "........................................................................................................................",
    "........................................................................................................................",
    "........................................................................................................................",
    "........................................................................................................................",
    "........................................................................................................................"
  ],
  "entities": {},
  "module_sockets": []
}