{
  "map_id": "sanctuary",
  "dimensions": {
    "width": 32,
    "height": 22
  },
  "legend": {
    "#": "Wall Tile",
    ".": "Floor Tile",
    "B": "Barrel",
    "S": "Bench",
    "l": "Candelabra",
    "v": "Ink Puddle",
    "d": "Ink Urn",
    "h": "Bookcase",
    "T": "Structure",
    "K": "Rock",
    "W": "Warp",
    "P": "Player Start",
    "C": "Chronicler",
    "F": "Wellspring",
    "L": "Lore",
    "R": "Respite",
    "A": "Bat",
    "Z": "Slug",
    "f": "Flutter",
    "b": "Bindling",
    "s": "Smear",
    "E": "Miniboss M1",
    "2": "Miniboss M2",
    "3": "Miniboss M3"
  },
  "grid": [
    "################################",
    "#KKK.......................K...#",
    "#K.................BBB.....K...#",
    "#.........############....KK...#",
    "#K.......B#h...l...h.#...KK....#",
    "#K.......B#d.......d.#........S#",
    "#KK......B#..........#........S#",
    "#KK......B#L.C.P..F..#.........#",
    "#KK.......#d...v...d.#.....K...#",
    "#.K.......#....W.....#.....KK..#",
    "#.K.......#..........#......KKK#",
    "#.K.......#..........#.......K.#",
    "##KK##....####...#####.......###",
    "######KKK....................###",
    "#######.KK.................#####",
    "#######....................#####",
    "######....................######",
    "######....................######",
    "######....................######",
    "########.................K######",
    "##########..K.......K..KKK######",
    "################################"
  ],
  "entities": {
    "15,9": {
      "target": "macro_world",
      "name": "The Chronicle",
      "spawn_x": 680,
      "spawn_y": 280
    },
    "11,7": {
      "fragment_id": "chronicler_nature",
      "name": "Faded Note"
    }
  },
  "module_sockets": []
}