{
  "map_id": "smallcave",
  "dimensions": {
    "width": 40,
    "height": 40
  },
  "legend": {
    "#": "Wall Tile",
    ".": "Floor Tile",
    "B": "Barrel",
    "S": "Bench",
    "l": "Candelabra",
    "v": "Ink Puddle",
    "d": "Ink Urn",
    "h": "Bookcase",
    "T": "Structure",
    "K": "Rock",
    "W": "Warp",
    "P": "Player Start",
    "C": "Chronicler",
    "F": "Wellspring",
    "L": "Lore",
    "R": "Respite",
    "1": "Patrol Marker 1",
    "2": "Patrol Marker 2",
    "3": "Patrol Marker 3",
    "4": "Patrol Marker 4",
    "5": "Patrol Marker 5",
    "6": "Patrol Marker 6",
    "7": "Patrol Marker 7",
    "8": "Patrol Marker 8",
    "9": "Patrol Marker 9",
    "A": "Bat",
    "Z": "Slug",
    "f": "Flutter",
    "b": "Bindling",
    "s": "Smear",
    "E": "Miniboss M1"
  },
  "grid": [
    "........................................",
    "........................................",
    "........................................",
    ".....1..................................",
    "........................................",
    ".............2..........................",
    "........................................",
    "........................................",
    "........................................",
    "........................................",
    "....................B...................",
    ".....3..................................",
    "........................................",
    "........................................",
    "........................................",
    "...............A........................",
    "........................................",
    "........................................",
    "........................................",
    "........................................",
    "........................................",
    "........................................",
    "........................................",
    "........................................",
    "........................................",
    ".........................A..............",
    "........................................",
    "........................................",
    "........................................",
    "........................................",
    "....................B...................",
    "........................................",
    "........................................",
    "........................................",
    "........................................",
    "........................................",
    "........................................",
    "........................................",
    "........................................",
    "........................................"
  ],
  "entities": {},
  "module_sockets": []
}