{
  "map_id": "smallcave",
  "dimensions": {
    "width": 40,
    "height": 40
  },
  "legend": {
    "#": "WALL_STONE",
    " ": "FLOOR_CLEAN",
    ".": "FLOOR_CLEAN",
    "N": "Night Boss",
    "P": "PLAYER_START",
    "h": "Bookcase",
    "A": "Bat",
    "B": "Barrel"
  },
  "grid": [
    "........................................",
    "........................................",
    "........................................",
    "........................................",
    "........................................",
    "........................................",
    "........................................",
    "........................................",
    "........................................",
    "........................................",
    "....................B...................",
    "........................................",
    "........................................",
    "........................................",
    "........................................",
    "...............A........................",
    "........................................",
    "........................................",
    "........................................",
    "........................................",
    "........................................",
    "........................................",
    "........................................",
    "........................................",
    "........................................",
    ".........................A..............",
    "........................................",
    "........................................",
    "........................................",
    "........................................",
    "....................B...................",
    "........................................",
    "........................................",
    "........................................",
    "........................................",
    "........................................",
    "........................................",
    "........................................",
    "........................................",
    "........................................"
  ],
  "entities": {},
  "module_sockets": []
}