{
  "map_id": "test_map_w_m1_m2",
  "dimensions": {
    "width": 40,
    "height": 30
  },
  "legend": {
    "#": "WALL",
    ".": "EMPTY",
    "B": "BARREL",
    "S": "BENCH",
    "l": "CANDELABRA",
    "v": "INK_PUDDLE",
    "d": "INK_URN",
    "h": "BOOKCASE",
    "T": "STRUCTURE",
    "K": "ROCK",
    "W": "WARP",
    "P": "PLAYER_START",
    "C": "CHRONICLER",
    "F": "WELLSPRING",
    "L": "LORE",
    "R": "RESPITE",
    "A": "Bat",
    "Z": "Slug",
    "f": "Flutter",
    "b": "Bindling",
    "E": "M1 - Ink-Stained",
    "2": "M2 - Bleeding Scribe",
    "3": "M3 - Forgotten Binder"
  },
  "grid": [
    "########################################",
    "#.....................................##",
    "#.....................................##",
    "#.....................................##",
    "#.....................................##",
    "#...........f.........................##",
    "#.....................................##",
    "#.....................................##",
    "#.....................................##",
    "#...........f.........................##",
    "#...........f.........................##",
    "#......ff.f...........................##",
    "#.....................................##",
    "#.....................................##",
    "#.....................................##",
    "#.....................................##",
    "#.....................................##",
    "#.A...................................##",
    "#.....................................##",
    "#.....................................##",
    "#.....................................##",
    "#.....................................##",
    "#.................P...................##",
    "#.....................................##",
    "#.....................................##",
    "#........................R............##",
    "#.....................................##",
    "#.....................................##",
    "########################################",
    "########################################"
  ],
  "entities": {},
  "module_sockets": [
    {
      "name": "M1",
      "bounds": {
        "x": 3,
        "y": 3,
        "width": 7,
        "height": 7
      }
    },
    {
      "name": "M2",
      "bounds": {
        "x": 24,
        "y": 3,
        "width": 7,
        "height": 7
      }
    }
  ]
}