{
  "map_id": "testmap1",
  "dimensions": {
    "width": 41,
    "height": 31
  },
  "legend": {
    "#": "WALL",
    ".": "EMPTY",
    "B": "BARREL",
    "S": "BENCH",
    "l": "CANDELABRA",
    "v": "INK_PUDDLE",
    "d": "INK_URN",
    "h": "BOOKCASE",
    "T": "STRUCTURE",
    "K": "ROCK",
    "W": "WARP",
    "P": "PLAYER_START",
    "C": "CHRONICLER",
    "F": "WELLSPRING",
    "L": "LORE",
    "R": "RESPITE",
    "A": "BAT_SPAWN",
    "Z": "SLUG_SPAWN",
    "E": "MINIBOSS_SPAWN"
  },
  "grid": [
    "#########################################",
    "#########################################",
    "#########################################",
    "#########################################",
    "########..............###################",
    "########..............###################",
    "########..............###################",
    "########..........KK..###################",
    "#################.KK..###################",
    "#####...A..######.....###################",
    "####..........###.....###################",
    "####..###...Z.###.....###################",
    "###...#####.....E.....###################",
    "###...######..........#####..############",
    "###..########..........###...############",
    "###..########...##########...############",
    "###..########....#########..#############",
    "###..####################..##############",
    "###..###################...##############",
    "###.....#######...........###############",
    "####....####..............###############",
    "#####....#...............################",
    "######P........##########################",
    "#######......############################",
    "#########################################",
    "#########################################",
    "#########################################",
    "#########################################",
    "#########################################",
    "#########################################",
    "#########################################"
  ],
  "entities": {}
}