{
  "map_id": "the_colophon",
  "dimensions": {
    "width": 40,
    "height": 40
  },
  "legend": {
    "#": "WALL_STONE",
    " ": "FLOOR_CLEAN",
    ".": "FLOOR_CLEAN",
    "N": "Night Boss",
    "P": "PLAYER_START",
    "h": "Bookcase",
    "A": "Bat",
    "B": "Barrel"
  },
  "grid": [
    "........................................",
    "........................................",
    "........................................",
    "........................................",
    "........................................",
    "........................................",
    "........................................",
    "........................................",
    "........................................",
    "........................................",
    "..........h...................h.........",
    "........................................",
    "........................................",
    "........................................",
    "........................................",
    "........................................",
    "........................................",
    "........................................",
    "........................................",
    "........................................",
    "....................P...................",
    "........................................",
    "........................................",
    "........................................",
    "........................................",
    "........................................",
    "........................................",
    "........................................",
    "........................................",
    "........................................",
    "..........h...................h.........",
    "........................................",
    "........................................",
    "........................................",
    "........................................",
    "........................................",
    "........................................",
    "........................................",
    "........................................",
    "........................................"
  ],
  "entities": {},
  "module_sockets": []
}