{
  "map_id": "the_colophon",
  "dimensions": { "width": 40, "height": 40 },
  "legend": {
    "#": "WALL_STONE",
    ".": "FLOOR_CLEAN",
    "P": "PLAYER_START"
  },
  "grid": [
    "########################################",
    "#......................................#",
    "#......................................#",
    "#......................................#",
    "#......................................#",
    "#......................................#",
    "#......................................#",
    "#......................................#",
    "#......................................#",
    "#......................................#",
    "#......................................#",
    "#......................................#",
    "#......................................#",
    "#......................................#",
    "#......................................#",
    "#......................................#",
    "#......................................#",
    "#......................................#",
    "#......................................#",
    "#..................P...................#",
    "#......................................#",
    "#......................................#",
    "#......................................#",
    "#......................................#",
    "#......................................#",
    "#......................................#",
    "#......................................#",
    "#......................................#",
    "#......................................#",
    "#......................................#",
    "#......................................#",
    "#......................................#",
    "#......................................#",
    "#......................................#",
    "#......................................#",
    "#......................................#",
    "#......................................#",
    "#......................................#",
    "#......................................#",
    "########################################"
  ],
  "entities": {},
  "module_sockets": []
}
