{
  "map_id": "chapter1",
  "dimensions": { "width": 80, "height": 38 },
  "legend": {
    "#": "WALL",
    ".": "EMPTY",
    "S": "BENCH",
    "K": "ROCK",
    "A": "BAT_SPAWN",
    "P": "PLAYER_START",
    "L": "LORE_FRAGMENT",
    "E": "MINIBOSS_SPAWN",
    "W": "WARP_PORTAL",
    "f": "FLUTTER_SPAWN",
    "b": "BINDLING_SPAWN",
    "2": "MINIBOSS_M2_SPAWN",
    "3": "MINIBOSS_M3_SPAWN"
  },
  "grid": [
    "################################################################################",
    "#..............................................................................#",
    "#..............................................................................#",
    "#...S..........................................................................#",
    "#..............................................................................#",
    "#............K.................................................................#",
    "#.......A......................................................................#",
    "#................PL.L..........................................................#",
    "#.......A......................................................................#",
    "#............K.................................................................#",
    "#...S..........................................................................#",
    "#......................................2.......................................#",
    "#......................................f..f....................................#",
    "#.....................................ff.ff....................................#",
    "#######################################.########################################",
    "#######################################.########################################",
    "#######################################.########################################",
    "#######################################.########################################",
    "#######################################.########################################",
    "#######################################.########################################",
    "#######################################.########################################",
    "#######################################.########################################",
    "#######################################.########################################",
    "#######################################.########################################",
    "#..............................................................................#",
    "#.......b......................................................................#",
    "#.......b......................................................................#",
    "#..............................................................................#",
    "#..............................................................................#",
    "#.......................................E......................................#",
    "#..............................................................................#",
    "#..............................................................................#",
    "#..............................................................................#",
    "#..............................................................................#",
    "#..............................................................................#",
    "#..............................................................................#",
    "#.......................................3............................W.........#",
    "#..............................................................................#",
    "################################################################################"
  ],
  "entities": {
    "68,36": {
      "target": "sanctuary",
      "name": "The Return",
      "spawn_x": 600,
      "spawn_y": 280
    },
    "18,7": {
      "fragment_id": "lotus_page",
      "name": "Torn Page"
    },
    "20,7": {
      "fragment_id": "half_cleft_manuscript",
      "name": "Half-Cleft Manuscript"
    }
  }
}
