{
  "map_id": "world_map1",
  "dimensions": {
    "width": 80,
    "height": 38
  },
  "legend": {
    "#": "WALL",
    ".": "EMPTY",
    "B": "BARREL",
    "S": "BENCH",
    "l": "CANDELABRA",
    "v": "INK_PUDDLE",
    "d": "INK_URN",
    "h": "BOOKCASE",
    "T": "STRUCTURE",
    "K": "ROCK",
    "W": "WARP",
    "P": "PLAYER_START",
    "C": "CHRONICLER",
    "F": "WELLSPRING",
    "L": "LORE",
    "R": "RESPITE",
    "A": "Bat",
    "Z": "Slug",
    "f": "Flutter",
    "b": "Bindling",
    "E": "M1 - Ink-Stained",
    "2": "M2 - Bleeding Scribe",
    "3": "M3 - Forgotten Binder"
  },
  "grid": [
    "################################################################################",
    "#..............................................................................#",
    "#.................................................................f............#",
    "#...S..................................................................f.......#",
    "#.....................................................................f........#",
    "#............K.................................................................#",
    "#.......A..............................................A......................b#",
    "#................PL.L..........................................................#",
    "#.......A................................................A.....................#",
    "#............K.................................................................#",
    "#...S..........................................................................#",
    "#......................................2.......................................#",
    "#......................................f..f.....................Z..............#",
    "#.....................................ff.ff..................Z.......Z.........#",
    "####..........................######........####################################",
    "#######...............#....###########.....#####################################",
    "###########......#####################....######################################",
    "######################################...#######################################",
    "######################################..########################################",
    "######################################..########################################",
    "######################################..########################################",
    "######################################..########################################",
    "#####################################...########################################",
    "#####################################.....######################################",
    "#............................................h..S.l.........A..A..A............#",
    "#.......b......................................................................#",
    "#.......b......................................................................#",
    "#..............................................................................#",
    "#..............................................................................#",
    "#.......................................E......................................#",
    "#..............................................................................#",
    "#..............................................................................#",
    "#.............................................................................Z#",
    "#..............................................................................#",
    "#....E.........................................................................#",
    "#..............................................................................#",
    "#.......................................3............................W........Z#",
    "#..............................................................................#",
    "################################################################################"
  ],
  "entities": {
    "68,36": {
      "target": "sanctuary",
      "name": "The Return",
      "spawn_x": 600,
      "spawn_y": 280
    },
    "18,7": {
      "fragment_id": "lotus_page",
      "name": "Torn Page"
    },
    "20,7": {
      "fragment_id": "half_cleft_manuscript",
      "name": "Half-Cleft Manuscript"
    }
  }
}