{
  "map_id": "world_map1_copy_2",
  "dimensions": {
    "width": 40,
    "height": 30
  },
  "legend": {
    "#": "Wall Tile",
    ".": "Floor Tile",
    "B": "Barrel",
    "S": "Bench",
    "l": "Candelabra",
    "v": "Ink Puddle",
    "d": "Ink Urn",
    "h": "Bookcase",
    "T": "Structure",
    "K": "Rock",
    "W": "Warp",
    "P": "Player Start",
    "C": "Chronicler",
    "F": "Wellspring",
    "L": "Lore",
    "R": "Respite",
    "A": "Bat",
    "Z": "Slug",
    "f": "Flutter",
    "b": "Bindling",
    "s": "Smear",
    "E": "Miniboss M1",
    "2": "Miniboss M2",
    "3": "Miniboss M3"
  },
  "grid": [
    "########################################",
    "#BBBBBBB.........s....................##",
    "#.....................................##",
    "#.....................................##",
    "#.....................................##",
    "#...........f.........................##",
    "#.....................................##",
    "#..................B..................##",
    "#.....................................##",
    "#...........f.........................##",
    "#...........f.........................##",
    "#B.....ff.f...........................##",
    "#B....................................##",
    "#B....................................##",
    "#B....................................##",
    "#B....................................##",
    "#.....................................##",
    "#.A........................W..........##",
    "#.....................................##",
    "#.....................................##",
    "#.....................................##",
    "#.....................................##",
    "#.................P...................##",
    "#.....................................##",
    "#.....................................##",
    "#........................R............##",
    "#.E...................................##",
    "#.....................................##",
    "########################################",
    "########################################"
  ],
  "entities": {},
  "module_sockets": [
    {
      "name": "M1",
      "bounds": {
        "x": 3,
        "y": 3,
        "width": 7,
        "height": 7
      },
      "active_plug": "maps/test_m1.json"
    },
    {
      "name": "M2",
      "bounds": {
        "x": 24,
        "y": 3,
        "width": 7,
        "height": 7
      },
      "active_plug": "maps/test_m2.json"
    }
  ]
}