{
  "map_id": "chapter1",
  "dimensions": { "width": 80, "height": 38 },
  "legend": {
    "#": "WALL",
    ".": "EMPTY",
    "S": "BENCH",
    "K": "ROCK",
    "A": "BAT_SPAWN",
    "P": "PLAYER_START",
    "L": "LORE_FRAGMENT",
    "E": "MINIBOSS_SPAWN",
    "W": "WARP_PORTAL",
    "f": "FLUTTER_SPAWN",
    "b": "BINDLING_SPAWN"
  },
  "grid": [
    "################################################################################",
    "#..............................................................................#",
    "#..............................................................................#",
    "#...S..........................................................................#",
    "#..............................................................................#",
    "#............K.................................................................#",
    "#.......A......................................................................#",
    "#................PL............................................................#",
    "#.......A......................................................................#",
    "#............K.................................................................#",
    "#...S..........................................................................#",
    "#..............................................................................#",
    "#......................................f..f....................................#",
    "#.....................................ff.ff....................................#",
    "#######################################.########################################",
    "#######################################.########################################",
    "#######################################.########################################",
    "#######################################.########################################",
    "#######################################.########################################",
    "#######################################.########################################",
    "#######################################.########################################",
    "#######################################.########################################",
    "#######################################.########################################",
    "#######################################.########################################",
    "#..............................................................................#",
    "#.......b......................................................................#",
    "#.......b......................................................................#",
    "#..............................................................................#",
    "#..............................................................................#",
    "#.......................................E......................................#",
    "#..............................................................................#",
    "#..............................................................................#",
    "#..............................................................................#",
    "#..............................................................................#",
    "#..............................................................................#",
    "#..............................................................................#",
    "#....................................................................W.........#",
    "#..............................................................................#",
    "################################################################################"
  ],
  "entities": {
    "68,35": {
      "target": "sanctuary",
      "name": "The Return",
      "spawn_x": 600,
      "spawn_y": 280
    },
    "18,7": {
      "fragment_id": "lotus_page",
      "name": "Torn Page"
    }
  }
}
